%%%%%%%%%%%%%%%%%%%%%%%%%%%%%%%%%%%%%%%%%%
%                                       .%
%                                        %
%                                        %
%                                        %
%                                        %
%                                        %
%                                        %
%                                        %
%                                        %
%                                        %
%                                        %
%                                        %
%                                        %
%                                        %
%                                        %
%                   P                    %
%                                        %
%                                        %
%                                        %
%                                        %
%                                        %
%                                        %
%                                        %
%                                        %
%                                        %
%                                        %
%                                        %
%                                        %
%                                        %
%%%%%%%%%%%%%%%%%%%%%%%%%%%%%%%%%%%%%%%%%%